a	aa
m	m
o	o
aa	aa
ai	ai
ak	ak
am	am
ap	ap
ar	aa
au	au
ba	baa
bo	bo
ca	caa
ce	ce
ci	ci
co	co
da	daa
de	de
di	di
do	do
fa	faa
fo	fo
fu	fu
ga	gaa
ge	ge
go	go
gu	gu
ha	haa
ho	ho
ja	jaa
je	je
ji	ji
ka	kaa
ke	ke
ku	ku
la	laa
le	le
lo	lo
ma	maa
me	me
mo	mo
na	naa
ne	ne
ng	ng
ni	ni
no	no
oi	oi
ok	ok
om	am
on	on
or	o
ou	ou
pa	paa
po	po
sa	saa
se	se
si	si
so	so
ta	taa
to	to
uk	uk
um	am
wa	waa
we	we
wo	wo
wu	wu
ya	jaa
ye	je
yi	ji
yu	jyu
za	zaa
ze	ze
zi	zi
zo	zo
aai	aai
aak	aak
aan	aan
aap	aap
aat	aat
aau	aau
ang	ang
baa	baa
bai	bai
bak	bak
ban	ban
bar	baa
bat	bat
bau	bau
bay	bei
bei	bei
bik	bik
bin	bin
bit	bit
biu	biu
bok	bok
bor	bo
bou	bou
bui	bui
buk	buk
bun	bun
but	but
caa	caa
cai	cai
cak	cak
cam	cam
can	can
cap	cap
car	caa
cat	cat
cau	cau
cee	ci
cek	cek
cha	caa
che	ce
chi	ci
cho	co
chu	cyu
cik	cik
cim	cim
cin	cin
cip	cip
cit	cit
ciu	ciu
coi	coi
cok	cok
cor	co
cou	cou
coy	coi
cui	ceoi
cuk	cuk
cum	cam
cup	cap
cyu	cyu
daa	daa
dai	dai
dak	dak
dam	dam
dan	dan
dap	dap
dar	daa
dat	dat
dau	dau
day	dei
dei	dei
dik	dik
dim	dim
din	din
dip	dip
dit	dit
diu	diu
doe	doe
doi	doi
dok	dok
dor	do
dou	dou
doy	doi
dui	deoi
duk	duk
dum	dam
dup	dap
faa	faa
fai	fai
fan	fan
far	faa
fat	fat
fau	fau
fei	fei
fok	fok
for	fo
fui	fui
fuk	fuk
fun	fun
fut	fut
gaa	gaa
gai	gai
gam	gam
gan	gan
gap	gap
gar	gaa
gat	gat
gau	gau
gay	gei
gei	gei
gik	gik
gim	gim
gin	gin
gip	gip
git	git
giu	giu
goe	goe
goi	goi
gok	gok
gom	gam
gon	gon
gop	gap
gor	go
got	got
gou	gou
goy	goi
gui	gui
guk	guk
gum	gam
gun	gun
gup	gap
gwa	gwaa
gwo	gwo
gwu	gu
haa	haa
hai	hai
hak	hak
ham	ham
han	han
hap	hap
har	haa
hat	hat
hau	hau
hei	hei
hek	hek
hey	hei
hik	hik
him	him
hin	hin
hip	hip
hit	hit
hiu	hiu
hoe	hoe
hoi	hoi
hok	hok
hom	ham
hon	hon
hop	hap
hor	ho
hot	hot
hou	hou
hoy	hoi
hui	heoi
huk	huk
hum	ham
hup	hap
jaa	jaa
jai	jai
jam	jam
jan	jan
jap	jap
jat	jat
jau	jau
jik	jik
jim	jim
jin	jin
jip	jip
jit	jit
jiu	jiu
juk	juk
jum	jam
jup	jap
jyu	jyu
kaa	kaa
kai	kai
kam	kam
kan	kan
kap	kap
kar	kaa
kat	kat
kau	kau
kay	kei
kei	kei
kek	kek
kik	kik
kim	kim
kin	kin
kit	kit
kiu	kiu
koi	koi
kok	kok
koy	koi
kui	kui
kuk	kuk
kum	kam
kup	kap
kut	kut
kwa	kwaa
kwu	ku
laa	laa
lai	lai
lak	lak
lam	lam
lan	lan
lap	lap
lar	laa
lat	lat
lau	lau
lay	lei
lei	lei
lek	lek
lik	lik
lim	lim
lin	lin
lip	lip
lit	lit
liu	liu
loe	loe
loi	loi
lok	lok
lor	lo
lou	lou
loy	loi
lui	leoi
luk	luk
lum	lam
lup	lap
maa	maa
mai	mai
mak	mak
man	man
mar	maa
mat	mat
mau	mau
may	mei
mei	mei
mik	mik
min	min
mit	mit
miu	miu
mok	mok
mor	mo
mou	mou
mui	mui
muk	muk
mun	mun
mut	mut
naa	naa
nai	nai
nam	nam
nan	nan
nap	nap
nar	naa
nat	nat
nau	nau
nay	nei
nei	nei
nga	ngaa
ngo	ngo
nik	nik
nim	nim
nin	nin
nip	nip
nit	nit
niu	niu
noi	noi
nok	nok
nor	no
nou	nou
noy	noi
nui	neoi
nuk	nuk
num	nam
nup	nap
ong	ong
paa	paa
pai	pai
pan	pan
par	paa
pat	pat
pau	pau
pay	pei
pei	pei
pek	pek
pik	pik
pin	pin
pit	pit
piu	piu
pok	pok
por	po
pou	pou
pui	pui
puk	puk
pun	pun
put	put
saa	saa
sai	sai
sak	sak
sam	sam
san	san
sap	sap
sar	saa
sat	sat
sau	sau
say	sei
see	si
sei	sei
sek	sek
sha	saa
she	se
shi	si
sho	so
shu	syu
sik	sik
sim	sim
sin	sin
sip	sip
sit	sit
siu	siu
soe	soe
soi	soi
sok	sok
sor	so
sou	sou
soy	soi
sui	seoi
suk	suk
sum	sam
sup	sap
syu	syu
taa	taa
tai	tai
tam	tam
tan	tan
tar	taa
tau	tau
tik	tik
tim	tim
tin	tin
tip	tip
tit	tit
tiu	tiu
toe	toe
toi	toi
tok	tok
tor	to
tou	tou
toy	toi
tui	teoi
tuk	tuk
tum	tam
ung	ung
waa	waa
wai	wai
wan	wan
war	waa
wat	wat
wik	wik
wok	wok
wor	wo
wui	wui
wun	wun
wut	wut
yaa	jaa
yai	jai
yam	jam
yan	jan
yap	jap
yat	jat
yau	jau
yik	jik
yim	jim
yin	jin
yip	jip
yit	jit
yiu	jiu
yom	jam
yop	jap
yui	jeoi
yuk	juk
yum	jam
yun	jyun
yup	jap
yut	jyut
zaa	zaa
zai	zai
zak	zak
zam	zam
zan	zan
zap	zap
zar	zaa
zat	zat
zau	zau
zek	zek
zha	zaa
zhe	ze
zhi	zi
zho	zo
zhu	zyu
zik	zik
zim	zim
zin	zin
zip	zip
zit	zit
ziu	ziu
zoi	zoi
zok	zok
zor	zo
zou	zou
zoy	zoi
zui	zeoi
zuk	zuk
zum	zam
zup	zap
zyu	zyu
baai	baai
baak	baak
baan	baan
baat	baat
baau	baau
bang	bang
been	bin
beng	beng
bing	bing
bong	bong
bung	bung
caai	caai
caak	caak
caam	caam
caan	caan
caap	caap
caat	caat
caau	caau
cang	cang
ceng	ceng
ceoi	ceoi
ceok	coek
ceon	ceon
ceot	ceot
ceoy	ceoi
ceui	ceoi
ceuk	coek
ceun	ceon
ceut	ceot
ceuy	ceoi
chaa	caa
chai	cai
chak	cak
cham	cam
chan	can
chap	cap
char	caa
chat	cat
chau	cau
chee	ci
chek	cek
chik	cik
chim	cim
chin	cin
chip	cip
chit	cit
chiu	ciu
choi	coi
chok	cok
chor	co
chou	cou
choy	coi
chue	cyu
chui	ceoi
chuk	cuk
chum	cam
chup	cap
chyu	cyu
cing	cing
coei	ceoi
coek	coek
coen	ceon
coet	ceot
coey	ceoi
cong	cong
cuen	cyun
cuet	cyut
cung	cung
cyun	cyun
cyut	cyut
daai	daai
daam	daam
daan	daan
daap	daap
daat	daat
dang	dang
deng	deng
deoi	deoi
deok	doek
deon	deon
deot	deot
deoy	deoi
deui	deoi
deuk	doek
deun	deon
deut	deot
deuy	deoi
ding	ding
doei	deoi
doek	doek
doen	deon
doet	deot
doey	deoi
dong	dong
duen	dyun
duet	dyut
dung	dung
dyun	dyun
dyut	dyut
faai	faai
faan	faan
faat	faat
fong	fong
fung	fung
gaai	gaai
gaak	gaak
gaam	gaam
gaan	gaan
gaap	gaap
gaat	gaat
gaau	gaau
gang	gang
geng	geng
geoi	geoi
geok	goek
geoy	geoi
geui	geoi
geuk	goek
geuy	geoi
ging	ging
goei	geoi
goek	goek
goey	geoi
gong	gong
guen	gyun
guet	gyut
gung	gung
gwaa	gwaa
gwai	gwai
gwan	gwan
gwat	gwat
gwik	gwik
gwok	gwok
gwor	gwo
gwui	gui
gwun	gun
gyun	gyun
gyut	gyut
haai	haai
haak	haak
haam	haam
haan	haan
haap	haap
haau	haau
hang	hang
heng	heng
heoi	heoi
heoy	heoi
heui	heoi
heuy	heoi
hing	hing
hoei	heoi
hoey	heoi
hong	hong
huen	hyun
huet	hyut
hung	hung
hyun	hyun
hyut	hyut
jaak	jaak
jeoi	jeoi
jeok	joek
jeon	jeon
jeoy	jeoi
jeui	jeoi
jeuk	joek
jeun	jeon
jeuy	jeoi
jing	jing
joei	jeoi
joek	joek
joen	jeon
joey	jeoi
jung	jung
jyun	jyun
jyut	jyut
kaai	kaai
kaau	kaau
kang	kang
keoi	keoi
keok	koek
keoy	keoi
keui	keoi
keuk	koek
keuy	keoi
king	king
koei	keoi
koek	koek
koey	keoi
kong	kong
kuen	kyun
kuet	kyut
kung	kung
kwaa	kwaa
kwai	kwai
kwan	kwan
kwik	kwik
kwok	kwok
kwui	kui
kwut	kut
kyun	kyun
kyut	kyut
laai	laai
laak	laak
laam	laam
laan	laan
laap	laap
laat	laat
laau	laau
leng	leng
leoi	leoi
leok	loek
leon	leon
leot	leot
leoy	leoi
leui	leoi
leuk	loek
leun	leon
leut	leot
leuy	leoi
ling	ling
loei	leoi
loek	loek
loen	leon
loet	leot
loey	leoi
long	long
luen	lyun
luet	lyut
lung	lung
lyun	lyun
lyut	lyut
maai	maai
maak	maak
maan	maan
maat	maat
maau	maau
mang	mang
mean	min
meen	min
meng	meng
ming	ming
mong	mong
mung	mung
naai	naai
naam	naam
naan	naan
naap	naap
naat	naat
naau	naau
nang	nang
neoi	neoi
neot	neot
neoy	neoi
neui	neoi
neut	neot
neuy	neoi
ngaa	ngaa
ngai	ngai
ngak	ngak
ngam	ngam
ngan	ngan
ngap	ngap
ngat	ngat
ngau	ngau
ngoi	ngoi
ngok	ngok
ngon	ngon
ngor	ngo
ngou	ngou
ngum	ngam
ngup	ngap
ning	ning
noei	neoi
noet	neot
noey	neoi
nong	nong
nuen	nyun
nung	nung
nyun	nyun
paai	paai
paak	paak
paan	paan
paau	paau
pang	pang
peng	peng
ping	ping
pong	pong
pung	pung
saai	saai
saak	saak
saam	saam
saan	saan
saap	saap
saat	saat
saau	saau
sang	sang
seen	sin
seng	seng
seoi	seoi
seok	soek
seon	seon
seot	seot
seoy	seoi
seui	seoi
seuk	soek
seun	seon
seut	seot
seuy	seoi
shaa	saa
shai	sai
shak	sak
sham	sam
shan	san
shap	sap
shar	saa
shat	sat
shau	sau
shay	sei
shee	si
shei	sei
shek	sek
shik	sik
shim	sim
shin	sin
ship	sip
shit	sit
shiu	siu
shoe	soe
shoi	soi
shok	sok
shor	so
shou	sou
shoy	soi
shue	syu
shui	seoi
shuk	suk
shum	sam
shup	sap
shyu	syu
sing	sing
soei	seoi
soek	soek
soen	seon
soet	seot
soey	seoi
song	song
suen	syun
suet	syut
sung	sung
syun	syun
syut	syut
taai	taai
taam	taam
taan	taan
taap	taap
taat	taat
tang	tang
teen	tin
teng	teng
teoi	teoi
teon	teon
teot	teot
teoy	teoi
teui	teoi
teun	teon
teut	teot
teuy	teoi
ting	ting
toei	teoi
toen	teon
toet	teot
toey	teoi
tong	tong
tuen	tyun
tuet	tyut
tung	tung
tyun	tyun
tyut	tyut
waai	waai
waak	waak
waan	waan
waat	waat
wang	wang
wing	wing
wong	wong
yaak	jaak
yeoi	jeoi
yeok	joek
yeon	jeon
yeoy	jeoi
yeuk	joek
yeuy	jeoi
ying	jing
yoei	jeoi
yoek	joek
yoen	jeon
yoey	jeoi
yong	jung
yuen	jyun
yuet	jyut
yung	jung
zaai	zaai
zaak	zaak
zaam	zaam
zaan	zaan
zaap	zaap
zaat	zaat
zaau	zaau
zang	zang
zeng	zeng
zeoi	zeoi
zeok	zoek
zeon	zeon
zeot	zeot
zeoy	zeoi
zeui	zeoi
zeuk	zoek
zeun	zeon
zeut	zeot
zeuy	zeoi
zhaa	zaa
zhai	zai
zhak	zak
zham	zam
zhan	zan
zhap	zap
zhar	zaa
zhat	zat
zhau	zau
zhek	zek
zhik	zik
zhim	zim
zhin	zin
zhip	zip
zhit	zit
zhiu	ziu
zhoi	zoi
zhok	zok
zhor	zo
zhou	zou
zhoy	zoi
zhue	zyu
zhui	zeoi
zhuk	zuk
zhum	zam
zhup	zap
zhyu	zyu
zing	zing
zoei	zeoi
zoek	zoek
zoen	zeon
zoet	zeot
zoey	zeoi
zong	zong
zuen	zyun
zuet	zyut
zung	zung
zyun	zyun
zyut	zyut
baang	baang
caang	caang
ceong	coeng
ceung	coeng
chaai	caai
chaak	caak
chaam	caam
chaan	caan
chaap	caap
chaat	caat
chaau	caau
chang	cang
cheng	ceng
cheoi	ceoi
cheok	coek
cheon	ceon
cheot	ceot
cheoy	ceoi
cheui	ceoi
cheuk	coek
cheun	ceon
cheut	ceot
cheuy	ceoi
ching	cing
choei	ceoi
choek	coek
choen	ceon
choet	ceot
choey	ceoi
chong	cong
chuen	cyun
chuet	cyut
chung	cung
chyun	cyun
chyut	cyut
coeng	coeng
deong	doeng
deung	doeng
doeng	doeng
gaang	gaang
geong	goeng
geung	goeng
goeng	goeng
gwaai	gwaai
gwaan	gwaan
gwaat	gwaat
gwang	gwang
gwing	gwing
gwong	gwong
haang	haang
heong	hoeng
heung	hoeng
hoeng	hoeng
jeong	joeng
jeung	joeng
joeng	joeng
keong	koeng
keung	koeng
koeng	koeng
kwong	kwong
laang	laang
leong	loeng
leung	loeng
loeng	loeng
maang	maang
neong	noeng
neung	noeng
ngaai	ngaai
ngaak	ngaak
ngaam	ngaam
ngaan	ngaan
ngaat	ngaat
ngaau	ngaau
ngong	ngong
noeng	noeng
paang	paang
saang	saang
seong	soeng
seung	soeng
shaai	saai
shaak	saak
shaam	saam
shaan	saan
shaap	saap
shaat	saat
shaau	saau
shang	sang
sheen	sin
sheng	seng
sheoi	seoi
sheok	soek
sheon	seon
sheot	seot
sheoy	seoi
sheui	seoi
sheuk	soek
sheun	seon
sheut	seot
sheuy	seoi
shing	sing
shoei	seoi
shoek	soek
shoen	seon
shoet	seot
shoey	seoi
shong	song
shuen	syun
shuet	syut
shung	sung
shyun	syun
shyut	syut
soeng	soeng
waang	waang
yeong	joeng
yeung	joeng
yoeng	joeng
zaang	zaang
zeong	zoeng
zeung	zoeng
zhaai	zaai
zhaak	zaak
zhaam	zaam
zhaan	zaan
zhaap	zaap
zhaat	zaat
zhaau	zaau
zhang	zang
zheng	zeng
zheoi	zeoi
zheok	zoek
zheon	zeon
zheot	zeot
zheoy	zeoi
zheui	zeoi
zheuk	zoek
zheun	zeon
zheut	zeot
zheuy	zeoi
zhing	zing
zhoei	zeoi
zhoek	zoek
zhoen	zeon
zhoet	zeot
zhoey	zeoi
zhong	zong
zhuen	zyun
zhuet	zyut
zhung	zung
zhyun	zyun
zhyut	zyut
zoeng	zoeng
chaang	caang
cheong	coeng
cheung	coeng
choeng	coeng
gwaang	gwaang
kwaang	kwaang
ngaang	ngaang
shaang	saang
sheong	soeng
sheung	soeng
shoeng	soeng
zhaang	zaang
zheong	zoeng
zheung	zoeng
zhoeng	zoeng
